Аулофобия - боязнь флейт
Офидиофобия - боязнь змей
Арахнофобия - боязнь пауков
Орнитофобия - боязнь птиц и их перьев
Земмифобия - боязнь крыс
Аквафобия - боязнь утопления
Клаустрофобия - боязнь замкнутых пространств
Гелотофобия - боязнь насмешек
Клептофобия - боязнь быть ограбленным
Аграфобия - боязнь секса
Авиафобия — боязнь полётов в воздушных транспортных средствах
Агирофобия — боязнь улиц, пересекать улицу
Агорафобия — боязнь пространства, открытых мест, площадей, толп людей
Айлурофобия - боязнь кошек
Айхмофобия - боязнь острых предметов
Акрофобия - боязнь высоты
Акустикофобия - боязнь громких звуков
Андрофобия - боязнь мужчин
Апифобия - боязнь пчел и их укусов
Астрофобия - боязнь звезд
Атихифобия - боязнь совершить ошибку
Ахлуофобия - боязнь темноты
Барофобия - боязнь поъема тяжести
Винофобия - боязнь употребления вина 
Галеофобия - боязнь акул
Гаптефобия - боязнь прикосновения окружающих людей
Гедонофобия - боязнь удовольствия
Гелиофобия - боязнь солнечного света
Эпистемофобия - боязнь знаний, познания
Декстрофобия - боязнь вещей, расположенных справа
Демофобия - боязнь скопления людей
Децидофобия - боязнь принимать решения
Инсектофобия - боязнь насекомых
Кенофобия - боязнь больших незаполненных пространств
Копрофобия - боязнь фекалий
Коулрофобия - боязнь клоунов
Логофобия - боязнь говорить
Мирмекофобия - боязнь муравьев
Номофобия - боязнь остаться без телефона
Панофобия - боязнь всего
Пеладофобия - боязнь облысения
Пирофобия - боязнь огня
Психрофобия - боязнь холода
Радиофобия - боязнь радиации
Робофобия - боязнь по отношению к любой робототехнике
Спектрофобия - боязнь призраков
Сомнифобия - боязнь спать
Талласофобия - боязнь моря (в том числе и купаний)
Тетрафобия - боязнь числа 4
Трипанофобия - боязнь игл и уколов
Уранофобия - боязнь смотреть в небо
Фармакофобия - боязнь принимать лекарства
Хемофобия - боязнь химии
Хироптофобия - боязнь летучих мышей
Эвинофобия - боязнь лошадей
Эргофобия - боязнь работать, совершать какие-либо действия
Эйхофобия — боязнь произносить или выслушивать добрые пожелания
Тениофобия — боязнь заразиться глистами
Трихофобия - боязнь попадания волос в пищу, на одежду 
Танатофобия - боязнь смерти